border_size=1
usage=map

Iwr^_fme    , Iwr^_fme    , Iwr^_fme    , Iwr^_fme    , Iwr^_fme    , Iwr^_fme    , Iwr^_fme    , Iwr         , Iwr         , Iwr         , Iwr         , Iwr         , Xos         , Xos         , Xos         , Xos         , Xol         , Xos         , Xol         , Xos         , Xos         , Xos         , Xos         , Xos         , Xos         , Xos         , Xos         , Iwr         , Iwr         , Iwr         , Iwr         , Iwr         , Iwr         , Iwr         , Iwr         , Iwr         , Iwr         , Xos         , Xos         , Xos         , Xos         , Xos         , Xos         , Iwr         , Iwr         , Iwr         , Iwr         , Iwr         , Iwr         , Xos         , Gg          , Gg          
Iwr^_fme    , Iwr^_fme    , Iwr^_fme    , Iwr^_fme    , Iwr^_fme    , Iwr^_fme    , Iwr^_fme    , Iwr         , Iwr         , Iwr         , Iwr         , Iwr         , Xos         , Xos         , Xos         , Xol         , Iwr         , Iwr         , Iwr         , Xol         , Xos         , Xos         , Xos         , Xos         , Xos         , Xos         , Xos         , Iwr         , Iwr         , Iwr         , Iwr         , Iwr         , Iwr         , Iwr         , Iwr         , Iwr         , Iwr         , Xos         , Xos         , Xos         , Xos         , Xos         , Xos         , Iwr         , Iwr         , Iwr         , Iwr         , Iwr         , Iwr         , Xos         , Gg          , Gg          
Iwr^_fme    , Iwr^_fme    , Iwr^_fme    , Iwr^_fme    , Iwr^_fme    , Iwr^_fme    , Iwr^_fme    , Iwr         , Iwr         , Iwr         , Iwr         , Iwr         , Xos         , Xos         , Xos         , Xos         , Iwr         , Iwr         , Iwr         , Iwr         , Xos         , Xos         , Xos         , Xos         , Xos         , Xos         , Xos         , Iwr         , Iwr         , Iwr         , Iwr         , Iwr         , Iwr         , Iwr         , Iwr         , Iwr         , Iwr         , Xos         , Xos         , Xos         , Xos         , Xos         , Xos         , Iwr         , Iwr         , Iwr         , Iwr         , Iwr         , Iwr         , Xos         , Gg          , Gg          
Iwr^_fme    , Iwr^_fme    , Iwr^_fme    , Iwr^_fme    , Iwr^_fme    , Iwr^_fme    , Iwr^_fme    , Iwr         , Iwr         , Iwr         , Iwr         , Iwr         , Xos         , Xos         , Xos         , Xos         , Xos         , Iwr         , Iwr         , Iwr         , Xos         , Xos         , Xos         , Xos         , Xos         , Xos         , Xos         , Iwr         , Iwr         , Iwr         , Iwr         , Iwr         , Iwr         , Iwr         , Iwr         , Iwr         , Iwr         , Xos         , Xos         , Xos         , Xos         , Xos         , Xos         , Iwr         , Iwr         , Iwr         , Iwr         , Iwr         , Iwr         , Xos         , Gg          , Gg          
Iwr^_fme    , Iwr^_fme    , Iwr^_fme    , Iwr^_fme    , Iwr^_fme    , Iwr^_fme    , Iwr^_fme    , Iwr         , Iwr         , Iwr         , Iwr         , Iwr         , Xos         , Xos         , Xos         , Xos         , Xos         , Iwr         , Iwr         , Iwr         , Xos         , Xos         , Xos         , Xos         , Xos         , Xos         , Xos         , Iwr         , Iwr         , Iwr         , Iwr         , Iwr         , Iwr         , Iwr         , Iwr         , Iwr         , Iwr         , Xos         , Xos         , Xos         , Xos         , Xos         , Xos         , Iwr         , Iwr         , Iwr         , Iwr         , Iwr         , Iwr         , Xos         , Gg          , Gg          
Iwr^_fme    , Iwr^_fme    , Iwr^_fme    , Iwr^_fme    , Iwr^_fme    , Iwr^_fme    , Iwr^_fme    , Iwr         , Iwr         , Iwr         , Iwr         , Iwr         , Xos         , Xos         , Xos         , Xos         , Xos         , Iwr         , Iwr         , Iwr         , Xos         , Xos         , Xos         , Xos         , Xos         , Xos         , Iwr         , Iwr         , Iwr         , Iwr         , Iwr         , Iwr         , Iwr         , Iwr         , Iwr         , Iwr         , Iwr         , Xos         , Xos         , Xos         , Xos         , Xos         , Xos         , Iwr         , Iwr         , Iwr         , Iwr         , Iwr         , Iwr         , Xos         , Gg          , Gg          
Iwr^_fme    , Iwr^_fme    , Iwr^_fme    , Iwr^_fme    , Iwr^_fme    , Iwr^_fme    , Iwr^_fme    , Iwr         , Iwr         , Iwr         , Iwr         , Iwr         , Xol         , Xos         , Xos         , Xos         , Xol         , Iwr         , Iwr         , Iwr         , Xos         , Xos         , Xos         , Xos         , Xos         , Xos         , Iwr         , Iwr         , Iwr         , Iwr         , Iwr         , Iwr         , Iwr         , Iwr         , Iwr         , Iwr         , Iwr         , Xos         , Xos         , Xos         , Xos         , Xos         , Xos         , Iwr         , Iwr         , Iwr         , Iwr         , Iwr         , Iwr         , Xos         , Gg          , Gg          
Iwr^_fme    , Iwr^_fme    , Iwr^_fme    , Iwr^_fme    , Iwr^_fme    , Iwr^_fme    , Iwr^_fme    , Iwr         , Iwr         , Iwr         , Iwr         , Iwr         , Iwr         , Xol         , Xol         , Xol         , Iwr         , Iwr         , Xos         , Xos         , Xos         , Xos         , Xos         , Xos         , Xos         , Xos         , Iwr         , Iwr         , Iwr         , Iwr         , Iwr         , Iwr         , Iwr         , Iwr         , Iwr         , Iwr         , Iwr         , Xol         , Xol         , Xos         , Xos         , Xos         , Xol         , Iwr         , Iwr         , Iwr         , Iwr         , Iwr         , Iwr         , Xos         , Gg          , Gg          
Iwr^_fme    , Iwr^_fme    , Iwr^_fme    , Iwr^_fme    , Iwr^_fme    , Iwr^_fme    , Iwr^_fme    , Iwr         , Iwr         , Iwr         , Iwr         , Iwr         , Iwr         , Iwr         , Iwr         , Iwr         , Iwr         , Xos         , Xos         , Xos         , Xos         , Xos         , Xos         , Xos         , Xol         , Xol         , Iwr         , Iwr         , Iwr         , Iwr         , Iwr         , Iwr         , Iwr         , Iwr         , Iwr         , Iwr         , Iwr         , Iwr         , Iwr         , Xol         , Xol         , Xol         , Iwr         , Iwr         , Iwr         , Iwr         , Iwr         , Iwr         , Iwr         , Xos         , Gg          , Gg          
Iwr^_fme    , Iwr^_fme    , Iwr^_fme    , Iwr^_fme    , Iwr^_fme    , Iwr^_fme    , Iwr^_fme    , Iwr         , Iwr         , Iwr         , Iwr         , Iwr         , Iwr         , Iwr         , Iwr         , Iwr         , Iwr         , Xol         , Xol         , Xos         , Iwr         , Xos         , Xos         , Iwr         , Iwr         , Iwr         , Iwr         , Iwr         , Iwr         , Iwr         , Iwr         , Iwr         , Iwr         , Iwr         , Iwr         , Iwr         , Iwr         , Iwr         , Iwr         , Iwr         , Iwr         , Iwr         , Iwr         , Iwr         , Iwr         , Iwr         , Iwr         , Iwr         , Iwr         , Xos         , Gg          , Gg          
Iwr^_fme    , Iwr^_fme    , Iwr^_fme    , Iwr^_fme    , Iwr^_fme    , Iwr^_fme    , Iwr^_fme    , Iwr         , Iwr         , Iwr         , Iwr         , Iwr         , Iwr         , Iwr         , Iwr         , Iwr         , Iwr         , Iwr         , Iwr         , Iwr         , Iwr         , Iwr         , Xos         , Xos         , Xos         , Xos         , Xos         , Iwr         , Iwr         , Iwr         , Iwr         , Iwr         , Iwr         , Iwr         , Iwr         , Iwr         , Iwr         , Iwr         , Xos         , Xos         , Xos         , Iwr         , Iwr         , Iwr         , Iwr         , Iwr         , Iwr         , Iwr         , Iwr         , Xos         , Gg          , Gg          
Iwr^_fme    , Iwr^_fme    , Iwr^_fme    , Iwr^_fme    , Iwr^_fme    , Iwr^_fme    , Iwr^_fme    , Iwr         , Iwr         , Iwr         , Iwr         , Iwr         , Iwr         , Iwr         , Iwr         , Iwr         , Iwr         , Iwr         , Iwr         , Iwr         , Iwr         , Iwr         , Xos         , Xos         , Xos         , Xos         , Xos         , Xos         , Iwr         , Iwr         , Iwr         , Iwr         , Iwr         , Iwr         , Iwr         , Iwr         , Iwr         , Xos         , Xos         , Xos         , Xos         , Xos         , Xos         , Iwr         , Iwr         , Iwr         , Iwr         , Iwr         , Iwr         , Xos         , Gg          , Gg          
Iwr^_fme    , Iwr^_fme    , Iwr^_fme    , Iwr^_fme    , Iwr^_fme    , Iwr^_fme    , Iwr^_fme    , Iwr         , Iwr         , Iwr         , Iwr         , Iwr         , Iwr         , Iwr         , Iwr         , Iwr         , Iwr         , Iwr         , Iwr         , Iwr         , Iwr         , Iwr         , Xos         , Xos         , Xos         , Xos         , Xos         , Xos         , Iwr         , Iwr         , Iwr         , Iwr         , Iwr         , Iwr         , Iwr         , Iwr         , Iwr         , Xos         , Xos         , Xos         , Xos         , Xos         , Xol         , Iwr         , Iwr         , Iwr         , Iwr         , Iwr         , Iwr         , Xos         , Gg          , Gg          
Iwr^_fme    , Iwr^_fme    , Iwr^_fme    , Iwr^_fme    , Iwr^_fme    , Iwr^_fme    , Iwr^_fme    , Iwr         , Iwr         , Iwr         , Iwr         , Iwr         , Iwr         , Iwr         , Iwr         , Iwr         , Iwr         , Iwr         , Iwr         , Iwr         , Iwr         , Iwr         , Xos         , Xos         , Xos         , Xos         , Xos         , Xos         , Iwr         , Iwr         , Iwr         , Iwr         , Iwr         , Iwr         , Iwr         , Iwr         , Iwr         , Xos         , Xos         , Xos         , Xol         , Xol         , Iwr         , Iwr         , Iwr         , Iwr         , Iwr         , Iwr         , Iwr         , Xos         , Gg          , Gg          
Iwr^_fme    , Iwr^_fme    , Iwr^_fme    , Iwr^_fme    , Iwr^_fme    , Iwr^_fme    , Iwr^_fme    , Iwr         , Iwr         , Iwr         , Iwr         , Iwr         , Iwr         , Iwr         , Iwr         , Iwr         , Iwr         , Iwr         , Iwr         , Iwr         , Iwr         , Iwr         , Xos         , Xos         , Xos         , Xos         , Xos         , Xos         , Iwr         , Iwr         , Iwr         , Iwr         , Iwr         , Iwr         , Iwr         , Iwr         , Iwr         , Xol         , Xol         , Xol         , Iwr         , Iwr         , Iwr         , Iwr         , Iwr         , Iwr         , Iwr         , Iwr         , Iwr         , Xos         , Gg          , Gg          
Iwr^_fme    , Iwr^_fme    , Iwr^_fme    , Iwr^_fme    , Iwr^_fme    , Iwr^_fme    , Iwr^_fme    , Iwr         , Iwr         , Iwr         , Iwr         , Iwr         , Iwr         , Iwr         , Iwr         , Iwr         , Iwr         , Iwr         , Iwr         , Iwr         , Iwr         , Xos         , Xos         , Xos         , Xos         , Xos         , Xos         , Xos         , Iwr         , Iwr         , Iwr         , Iwr         , Iwr         , Iwr         , Iwr         , Iwr         , Iwr         , Iwr         , Iwr         , Iwr         , Xos         , Iwr         , Iwr         , Iwr         , Iwr         , Iwr         , Iwr         , Iwr         , Iwr         , Xos         , Gg          , Gg          
Iwr^_fme    , Iwr^_fme    , Iwr^_fme    , Iwr^_fme    , Iwr^_fme    , Iwr^_fme    , Iwr^_fme    , Iwr         , Iwr         , Iwr         , Iwr         , Iwr         , Iwr         , Iwr         , Iwr         , Iwr         , Iwr         , Iwr         , Iwr         , Iwr         , Iwr         , Xos         , Xos         , Xos         , Xos         , Xos         , Xos         , Xos         , Iwr         , Iwr         , Iwr         , Iwr         , Iwr         , Iwr         , Xos         , Xos         , Xos         , Iwr         , Xos         , Xos         , Xos         , Xos         , Xos         , Iwr         , Iwr         , Iwr         , Iwr         , Iwr         , Iwr         , Xos         , Gg          , Gg          
Iwr^_fme    , Iwr^_fme    , Iwr^_fme    , Iwr^_fme    , Iwr^_fme    , Iwr^_fme    , Iwr^_fme    , Iwr         , Iwr         , Iwr         , Iwr         , Iwr         , Iwr         , Iwr         , Iwr         , Iwr         , Iwr         , Iwr         , Iwr         , Iwr         , Iwr         , Xos         , Iwr         , Xos         , Xos         , Xos         , Xol         , Xol         , Iwr         , Iwr         , Iwr         , Iwr         , Iwr         , Xos         , Xos         , Xos         , Xos         , Xos         , Xos         , Xos         , Xos         , Xos         , Xos         , Iwr         , Iwr         , Iwr         , Iwr         , Iwr         , Iwr         , Xos         , Gg          , Gg          
Iwr^_fme    , Iwr^_fme    , Iwr^_fme    , Iwr^_fme    , Iwr^_fme    , Iwr^_fme    , Iwr^_fme    , Iwr         , Iwr         , Iwr         , Iwr         , Iwr         , Iwr         , Iwr         , Iwr         , Iwr         , Iwr         , Iwr         , Iwr         , Iwr         , Iwr         , Xos         , Iwr         , Xol         , Xol         , Xol         , Iwr         , Iwr         , Iwr         , Iwr         , Iwr         , Iwr         , Iwr         , Xos         , Xos         , Xos         , Xos         , Xos         , Xos         , Xos         , Xos         , Xos         , Xos         , Iwr         , Iwr         , Iwr         , Iwr         , Iwr         , Iwr         , Xol         , Xol         , Gg          
Iwr^_fme    , Iwr^_fme    , Iwr^_fme    , Iwr^_fme    , Iwr^_fme    , Iwr^_fme    , Iwr^_fme    , Iwr         , Iwr         , Iwr         , Iwr         , Iwr         , Iwr         , Iwr         , Iwr         , Iwr         , Iwr         , Iwr         , Iwr         , Iwr         , Iwr         , Xos         , Iwr         , Iwr         , Iwr         , Iwr         , Xos         , Iwr         , Iwr         , Iwr         , Iwr         , Iwr         , Xos         , Xos         , Xos         , Xos         , Xos         , Xos         , Xos         , Xos         , Xos         , Xos         , Xos         , Iwr         , Iwr         , Iwr         , Iwr         , Iwr         , Iwr         , Iwr         , Iwr         , Xol         
Iwr^_fme    , Iwr^_fme    , Iwr^_fme    , Iwr^_fme    , Iwr^_fme    , Iwr^_fme    , Iwr^_fme    , Iwr         , Iwr         , Iwr         , Iwr         , Iwr         , Iwr         , Iwr         , Iwr         , Iwr         , Iwr         , Iwr         , Iwr         , Iwr         , Iwr         , Xos         , Xos         , Xos         , Xos         , Xos         , Xos         , Xos         , Xos         , Iwr         , Iwr         , Iwr         , Xos         , Xos         , Xos         , Xos         , Xos         , Xos         , Xos         , Xos         , Xos         , Xos         , Xos         , Iwr         , Iwr         , Iwr         , Iwr         , Iwr         , 1 Iwr       , Iwr         , Iwr         , Iwr         
Iwr^_fme    , Iwr^_fme    , Iwr^_fme    , Iwr^_fme    , Iwr^_fme    , Iwr^_fme    , Iwr^_fme    , Iwr         , Ch          , Iwr         , Iwr         , Iwr         , Iwr         , Iwr         , Iwr         , Iwr         , Iwr         , Iwr         , Iwr         , Iwr         , Iwr         , Xos         , Xos         , Xos         , Xos         , Xos         , Xos         , Xos         , Xos         , Xos         , Iwr         , Iwr         , Xos         , Xos         , Xos         , Xos         , Xos         , Xos         , Xos         , Xos         , Xos         , Xos         , Xos         , Iwr         , Iwr         , Iwr         , Iwr         , Iwr         , Iwr         , Iwr         , Iwr         , Iwr         
Iwr^_fme    , Iwr^_fme    , Iwr^_fme    , Iwr^_fme    , Iwr^_fme    , Iwr^_fme    , Iwr^_fme    , Ch          , 2 Kh        , Ch          , Iwr         , Iwr         , Iwr         , Iwr         , Iwr         , Iwr         , Iwr         , Iwr         , Iwr         , Iwr         , Iwr         , Xos         , Xos         , Xos         , Xos         , Xos         , Xos         , Xos         , Xos         , Xos         , Iwr         , Iwr         , Xos         , Xos         , Xos         , Xos         , Xos         , Xos         , Xos         , Xos         , Xos         , Xos         , Xos         , Iwr         , Iwr         , Iwr         , Iwr         , Iwr         , Iwr         , Iwr         , Xos         , Xos         
Iwr^_fme    , Iwr^_fme    , Iwr^_fme    , Iwr^_fme    , Iwr^_fme    , Iwr^_fme    , Iwr^_fme    , Ch          , Ch          , Ch          , Iwr         , Iwr         , Iwr         , Iwr         , Iwr         , Iwr         , Iwr         , Iwr         , Iwr         , Iwr         , Iwr         , Xos         , Xos         , Xos         , Xos         , Xos         , Xos         , Xos         , Xol         , Xol         , Iwr         , Iwr         , Xos         , Xos         , Xos         , Xos         , Xos         , Xos         , Xos         , Xos         , Xos         , Xos         , Xos         , Iwr         , Iwr         , Iwr         , Iwr         , Iwr         , Xos         , Xos         , Gg          , Gg          
Iwr^_fme    , Iwr^_fme    , Iwr^_fme    , Iwr^_fme    , Iwr^_fme    , Iwr^_fme    , Iwr^_fme    , Iwr         , Iwr         , Iwr         , Iwr         , Iwr         , Iwr         , Iwr         , Iwr         , Iwr         , Iwr         , Iwr         , Iwr         , Iwr         , Iwr         , Xos         , Xos         , Xos         , Xol         , Xos         , Xol         , Xol         , Iwr         , Iwr         , Iwr         , Iwr         , Xos         , Xos         , Xos         , Xos         , Xos         , Xos         , Xos         , Xos         , Xos         , Xos         , Xos         , Iwr         , Iwr         , Iwr         , Xos         , Xos         , Gg          , Gg          , Gg          , Gg          
Iwr^_fme    , Iwr^_fme    , Iwr^_fme    , Iwr^_fme    , Iwr^_fme    , Iwr^_fme    , Iwr^_fme    , Iwr         , Iwr         , Iwr         , Iwr         , Iwr         , Iwr         , Iwr         , Iwr         , Iwr         , Iwr         , Iwr         , Iwr         , Iwr         , Iwr         , Iwr^Xo      , Iwr         , Iwr         , Iwr         , Iwr         , Iwr         , Iwr         , Iwr         , Iwr         , Iwr         , Iwr         , Xos         , Xos         , Xos         , Xos         , Xos         , Xos         , Xos         , Xos         , Xos         , Xos         , Xos         , Iwr         , Iwr         , Xos         , Gg          , Gg          , Gg          , Gg          , Gg          , Gg          
Iwr^_fme    , Iwr^_fme    , Iwr^_fme    , Iwr^_fme    , Iwr^_fme    , Iwr^_fme    , Iwr^_fme    , Iwr         , Iwr         , Iwr         , Iwr         , Iwr         , Iwr         , Iwr         , Iwr         , Iwr         , Iwr         , Iwr         , Iwr         , Iwr         , Iwr         , Iwr^Xo      , Iwr         , Iwr         , Iwr         , Iwr         , Iwr         , Iwr         , Iwr         , Iwr         , Iwr         , Iwr         , Xos         , Xos         , Xos         , Xos         , Xos         , Xos         , Xos         , Xos         , Xos         , Xos         , Xos         , Xos         , Xos         , Xos         , Gg          , Gg          , Gg          , Gg          , Gg          , Gg          
